11111111111111111111111111
10P10000010000000001000001
1001000001000000D001CD0001
100100D000000000CD00111101
10D1000001000000D00E000001
100000D00100000000000000D1
1000000C0000000C0000000001
11111111111111111111111111