111111111111111
1E001000001C001
1000000C0000001
1P000001000C001
111111111111111