1111111111111111111111111111
10001000001C000001000001C001
1000000C000000000000C00000E1
1P000001000C00000000000C0001
1111111111111111111111111111