111111111111111111111111111111111111111111
10001000001C000001000001C0000001000001C001
1000000C000000000000C00000E00001000001C001
1P000001000C00000000000C00000001000001C001
111111111111111111111111111111111111111111