1111111111111111111111111111
10001000001000C00100000100E1
1P00100000100000010C00010001
1000000000000000000D00C00001
1000000000111000000000000001
10000010000000000000C0000001
1000001000000000000D00000001
1000001000C00000000000000001
1000000000000000000000000001
1111111111111111111111111111