1111111111111111111111111111
10001000001000C00100000100E1
1P00100000100000010C00010001
1111111111111111111111111111