1111111111111111111111111111
10001000001C000001000001C001