111111111111111
1E000000D010001
1001PD000001001
10D0100100000D1
111111111111111