111111111111111
1E000000D01C001
1001PD0C0001001
1CD01001000C0D1
111111111111111