111111111111111
1E000000D01C001
1001PD0C0000001
10001001000C001
111111111111111