111111111111111
1E001000001C001
1000P00C0000001
10000001000C001
111111111111111