111111111111111
1E001000P01C001
1000000C0000001
10000001000C001
111111111111111